......................###########........
......................#.........#........
......................#.........#........
......................#.........#........
......................#.........#........
......................#.........#........
......................#.........#####....
......................#.............#....
......................#.............#....
......................#.............#....
......#####.....#######.............#....
......#...#.....#...................#....
......#...#.....#...........#############
......#...#.....#...........#.......#...#
###########.....#...........#.......#...#
#.....#.........#...........#.......#...#
#.....#.......#####.........#.......#####
#.....#.......#.#.#.........#............
#.....#.......#.#.#.........#............
#.....#.......#.#.#.........#............
#############.#.#.#.........#............
......#.....#.#.#.#.........#............
......###########.###########............
............#.#..........................
..........##########^....................
..........#.#.#..........................
#####.....#.#.#############..............
#...#.....#.#.............#..............
#...#.....#.#.............#..............
#...#.....#.#.............#..............
#############.............#..............
....#.....#...............#..............
....#.....#...............###########....
....#.....#.........................#....
....#.....#.........................#....
....#.....#.........................#....
....#######.........................#....
....................................#....
....................................#....
....................................#....
....................................#....
....................................#....
..............................#######....
..............................#..........
..............................#..........
..............................#..........
..............................#..........
